Ароматерапия: Никитин,Даниил,Денисович
Астрология: Соколов,Ярослав,Иванович
Астрономия: Михайлова,Варвара,Марковна
Аэробика: Куликова,Малика,Львовна
Аэрография: Мартынова,Василиса,Матвеевна
Бадминтон: Александров,Борис,Владиславович
Батут: Федоров,Демид,Алексеевич
Бег: Маслова,Виктория,Яновна
Бильярд: Павлов,Павел,Семёнович
Блоггерство: Щукина,Вера,Никитовна
Боевые искусства: Селезнев,Константин,Владимирович
Бонсай: Шарапова,Алина,Леонидовна
Боулинг: Владимиров,Тимур,Семёнович
Велосипед: Исакова,Анна,Никитовна
Видеомонтаж: Жданова,Яна,Александровна
Выращивание кристаллов: Мишин,Егор,Валерьевич
Выращивание растений и цветов: Костина,Виктория,Игоревна
Вязание: Третьякова,Александра,Антоновна
Игра на органе: Константинова,Алёна,Данииловна
Наблюдение за насекомыми: Аксенова,Елизавета,Ильинична
Офтальмология: Зыков,Валентин,Степанович
Ролевые игры: Лихачев,Юрий,Эдуардович
Сексология: Никифоров,Степан,Сергеевич
Тренинги: Гурьев,Севастьян,Платонович
Физическая электроника: Устинов,Тихон,Геласьевич
Хирургическая онкология: Логинов,Ипполит,Созонович
Эзотерика: Гордеев,Панкрат,Ростиславович
Физическая электроника: Брагин,Даниил,Русланович
Хирургическая онкология: Федотов,Наум,Митрофанович
Эзотерика: Поляков,Юлий,Протасьевич